0  000
111111
100001
10N001
101101
100001
100001
110111
111111
