NO ./textures/bricks2.xpm
SO ./textures/bricks1.xpm
WE ./textures/dirt.xpm
EA ./textures/bricks2.xpm
F 220,100,0
C 225,30,0


1111111111111
1000000000001
10000N0000001
1000000000001
1000000000001
1111000011111
1000000000001
1000000000001
1000000000001
1100000000011
1100000000011
1111111111111
