




011110
111011
100001
10N001
101101
100001
100001
110111
111111
