NO ./textures/bricks1.xpm
SO ./textures/bricks2.xpm
WE ./textures/dirt.xpm
EA ./textures/lava.xpm

F 220,100,0
C 225,30,0

       1
      101
     10001
    1000001
   1000N0001
   111111111