NO ./textures/wood.xpm
SO ./textures/container.xpm
WE ./textures/lava.xpm
EA ./textures/card.xpm
F 220,100,0
C 225,30,0


      11111111111111111111
     1011111111111111111111
    1001         111111111
   10001         11111111
  100001        11111111
 1000001       11000111
1000000011111 1100011
11111000111111100011
     101    1100011
     1N1   11000111111111111
     111 1111111111111111111